111111111111111
111000000001111
11000CCP1100001
100000E11100111
100000000000001
111111111111111